********************************************************************************
*                                                 ******************************
*** ***** ****** ****************** ********************************************
*** ***** ****** ****************** ********************************************
*** *****        ****************** ********************************************
*** ***** *******    ************** ********************************************
*** ***** ********** ************** ******                                ******
*** ***** ********** ************** *********** ************************  ******
***                                  ********** ************************* ******
*** **************** **************  ********** ************************* ******
*** **************** **************  ********** ************************* ******
*** ******* ******** **************  ********** ************************* ******
*** **$     ******** **************  ********** ************************* ******
*** *** ***          **************                         ************* ******
*** *** ************ **************  ***************** ****************** ******
*** *** ************ ********************************* ****************** ******
*** ***    ********* ********************************* ****************** ******
*** ***    *********                                                      ******
*** ***    ********* ********************* *********** *************************
*** ***    ********* ********************* *********** *************************
*** ***    ********* ********************* *********** *************************
***                                                    *************************
********************************************************************************